NO ./textures/1.xpm                 
WE ./textures/2.xpm
EA ./textures/3.xpm
SO ./textures/4.xpm
   
F 44,45,44
C 142,145,143

1111111111111111111111111            
1000000000110000000000001
1011000001110000001000001                         
10010000000000000000010011111111111111111111111111111111111111111111111111111111111       
11111111101100000111W00000000000000000000000000000000000000000000000000000000000001
100000000011000001110111110111111111111111111111111111111111111111111111111111111111111
11110111111111011100000010001
11110111111111011101010010001
110000001101000000001011100001111111
110000001101000000001011100000000001
100010000000000000000001100001111111
10000000000000001101010010001
1100000111010101111101111000111
11110111 1110101 101111010001
11111111 1111111 111111111111
    
