NO ./textures/testwall.xpm                 
WE ./textures/testwall.xpm
EA ./textures/testwall.xpm
   
F 77,91,155
SO ./textures/testwall.xpm
C 163,208,230

    1111111111111111111111111            
    1000000000110000000000001
    1011000001110000001000001                         
    100100000000000000000100111111111       
    111111111011000001110000000000001
    100000000011000001110111110111111     
    11110111111111N11100000010001
    11110111111111011101010010001
    110000001101000000001011100001111111
    110000001101000000001011100000000001
    100010000000000000000001100001111111
    10000000000000001101010010001
    1100000111010101111101111000111
    11110111 1110101 101111010001
    11111111 1111111 111111111111
    
