1111111111111111
1000000000000001
10N0000111000001
1000000101000001
1000000111000001
1000000000000001
1111111111111111